XXXXXXXXXXXXXXXXXXXX
X                  X
XXXXXXXXXX     O   X
X                  X
X                  X
X   XXXXX   XXXXX  X
X                  X
X                  X
X   PPPPPPPPPPPP   X
X                  X
X                  X
XXXXXXXXX     XXXXXX
XO                 X
X                  X
XXXXXXXXXXXXXXXXXXXX
